11111111111111111111111111111111111111111111111111111111111111111111111111111111
1C|0|0000|0v00000000000001111111111000000011000000000000000000000000000111111111
11^1v1111+-+11100000000000001111111C0000000000000#####000000000000000#######1111
111111101111110000000...000000001110000000000#######000000000000C000000##00####1
100100000000000000......000001111000000000###C########00000001111000000##000###1
10011110000000.......00>0000000110000000##########00000000111110000000C0####00#1
100011111000000000....000000100000000000000###0000000000000001000000000000####01
100011C>000000..........0000110000000E0000000000000011100000.......0000000000001
10000111000000000000000000000000000000000000011100000000000.....C.....0000000111
10000010000000000000000C11000-->--+000000011111111100000000........0000000111111
100000000|000000000011111110000000|00000011+-----+11C000000000000000000000000011
10000....|.000000000011P0000011000|00011111|11111|111110000000000000000000000011
10000....|....00000000111110110000|00001100+---<-+C1111100000000000+<+0000000011
10000....|....00000000001111100000+---0000011111111110000C000000000vC^0000000001
10000....^....0000010000C110000000000000000001111110000000000000000+>+0000000011
10000....|....0000011000010000>0000001000000010000000000000000000000000000011111
100000000|0...000000001110000000000111100000000000000011101110000000000011111111
11111111111111111111111111111111111111111111111111111111111111111111111111111111
