11111111111111111111111111111111111111111111111111
1.....100000000000000000000001+-----------------+1
1.....100000000++0++0000000001|00000000000000000|1
1.....100000>+0^v0^^0000000001|00000000000000000|1
1.....10>0<0++0++0++0000000001|000000000000+-+00|1
1.....100000000000000000000001^000+-+0+>+00|++00|1
111011111111111111111111111111|000|0|0|0|00|^000|1
100000000000000000000000000001|000+-+-+-+00|++00v1
1P0000000000000000000000000000|00000v0|0000+-+00|1
1000000000000000000000000000E1|00000+-+-+0000000|1
111011111111111111111111111111|0000000|0v0000000|1
1CCCCC100000000000000000000001|0000000+-+000+-+0|1
1CCCCC10|00|00+-+000+->-+00001|0000000000|00|0|0|1
1CCCCC10v>-+00|0v000+--<+00001|0000000000+-->-+0|1
1CCCCC10|00v00+-+000+--<+00001|0000000000|000000|1
1CCCCC10---+00|000000000000001+----->-----------+1
11111111111111111111111111111111111111111111111111