11111
1v>11
1^<11
11111
1PCE1
11111