1111111
1>+C0.1
1++0001
1P000E1
1111111
