1111111
1>+C..1
1||0..1
1|++001
1+-+001
1000001
1P000E1
1111111
