111111111111111111111
100000000000000000001
100000000000000000001
100000000000000000001
100000000000000000001
100000000000000000001
100000000000000000001
100000000000000000001
100000000000000000001
100000000000000000001
100000000000000000001
100000000000000000001
100000000000000000001
100000000000000000001
100000000000000000001
100000000000000000001
1000000+-+00000000001
1000000^0|00000000001
1000000+-+>+000000001
100000000|0|000000001
100000000+-+-+0000001
10000000000|0|0000001
10000000000+-+00000C1
111111011111111111111
1P00000000000000000E1
111111111111111111111
