11111111111111111
1.....###.......1
1.....###.......1
1.....###.......1
1.....###.......1
1.....###.......1
1...............1
11111111011111111
1>---0000CCCCCCC1
1P0000000CCCCCCE1
11111111111111111
