1111111111111
1000000000001
10>+00.....01
10||00.....01
10||00.....01
10++00.....01
1000000000001
1000000000CC1
1111110111111
1P000000000E1
1111111111111